 0  0  0  0  0  0  0  0   0  0  0  0  0  0  0  0
 0  0  0  0  0  0  0  0   0  0  0  0  0  0  0  0
13 13 13 13 13 13 13 13  13 13 13 13 13 13 13 13
 0  0  0  0  0  0  0  0   0  0  0  0  0  0  0  0
 0  0  0  0  0  0  0  0   0  0  0  0  0  0  0  0
 0  0  0  0  0  0  0  0   0  0  0  0  0  0  0  0
 0  0  0  0  0  0  4  6  13  6  2  0  0  0  0  0
 0  0  0  0  0  0  0  0   0  0  0  0  0  0  0  0
 0  0  0  0  0  0  0  0   0  0  0  0  0  0  0  0
 0  0  1  0  0  0  0  0   0  0  0  0  0  0  0  0
 0  0  5  0  0  0  0  0   0  0  0  0  0  0  0  0
 0  0  3  0  0  0  0  0   0  0  0  0  0  0  0  0
 0  0  0  0  0  0  0  0   0  0  0  4  6  2  0  0
 0  0  0  0  0  0  0  0   0  0  0  0  0  0  0  0
 0  0  0  0  0  0  0  0   0  0  0  0  0  0  0  0
 0  0  0  0  0  0  0  0   0  0  0  0  0  0  0  0